++++++++++++++++++++++
+   +   ++ ++        +
      +     ++++++++++
+ +    ++  ++++ +++ ++
+ +   + + ++    +++  +
+          ++  ++  + +
+++++++ +      ++  + +
++  + +++  + +  ++   +
+          + + S+ +  +
+++++ +  + + +     + +
+    +  +++++++++++ ++
+  + T   ++++++  +++++
++++++++++++++++++++++
