++++++++++++
+++   +++T++
++     ++ ++
++ + +++   +
+++T+  +++ +
+++ +++ ++ +
+          +
++++S++++  +
++++   ++  +
++   + ++ ++
+ ++ ++++  +
+ ++ +++ + +
+ ++++   +  
+  ++  + +++
++      T+++
++++++++++++
